{'#','#','#','#','#','#','#','#','#','#','#','#','#','#','#','#','#','#','#','#','#','#','#','#','#','#','#','#','#','#','#','#','#','#','#','#','#','#','#','#','#','#','#','#','#','#'},
{'#',' ',' ',' ',' ',' ',' ',' ',' ',' ',' ',' ',' ',' ',' ','#',' ',' ',' ',' ',' ',' ',' ',' ',' ',' ',' ',' ',' ',' ',' ',' ',' ',' ',' ',' ',' ',' ',' ',' ',' ',' ',' ',' ',' ','#'},
{'#',' ',' ','#','#','#','#','#','#','#','#','#','#',' ',' ','#','#','#','#','#','#','#','#','#','#','#','#','#',' ',' ','#','#','#','#','#','#','#',' ',' ','#','#','#','#',' ',' ','#'},
{'#',' ',' ',' ',' ',' ',' ',' ',' ',' ',' ',' ','#',' ',' ',' ',' ',' ',' ',' ',' ',' ',' ',' ',' ',' ',' ',' ',' ',' ','#',' ',' ',' ',' ',' ',' ',' ',' ','#',' ',' ',' ',' ',' ','#'},
{'#',' ',' ','#','#','#','#','#','#','#',' ',' ','#','#','#','#','#','#','#','#','#','#','#','#','#',' ',' ','#','#','#','#','#','#','#','#','#','#','#','#','#','#','#','#','#','#','#'},
{'#',' ',' ','#',' ',' ',' ',' ',' ','#',' ',' ','#',' ',' ',' ',' ',' ',' ',' ',' ',' ',' ',' ','#',' ',' ','#',' ',' ',' ',' ',' ',' ',' ',' ',' ',' ',' ',' ',' ',' ',' ',' ',' ','#'},
{'#',' ',' ','#',' ',' ','#',' ',' ','#',' ',' ','#',' ',' ','#',' ',' ','#','#','#','#','#','#','#',' ',' ','#',' ',' ','#','#','#','#','#','#','#','#','#','#','#','#','#',' ',' ','#'},
{'#',' ',' ','#',' ',' ','#',' ',' ','#',' ',' ','#',' ',' ','#',' ',' ','#',' ',' ',' ',' ',' ','#',' ',' ','#',' ',' ','#',' ',' ','#',' ',' ',' ',' ',' ',' ',' ',' ','#',' ',' ','#'},
{'#',' ',' ','#',' ',' ','#','#','#','#',' ',' ','#',' ',' ','#','#','#','#','#','#','#','#','#','#',' ',' ','#',' ',' ','#','#','#','#',' ',' ','#',' ',' ','#',' ',' ','#',' ',' ','#'},
{'#',' ',' ','#',' ',' ',' ',' ',' ','#',' ',' ','#',' ',' ',' ',' ',' ',' ',' ',' ',' ',' ',' ',' ',' ',' ','#',' ',' ',' ',' ',' ',' ',' ',' ',' ',' ',' ','#',' ',' ','#',' ',' ','#'},
{'#',' ',' ','#','#','#','#',' ',' ','#',' ',' ','#','#','#','#','#','#','#','#','#','#','#','#','#','#','#','#',' ',' ','#','#','#','#','#','#','#','#','#','#','#','#','#',' ',' ','#'},
{'#',' ',' ',' ',' ',' ','#',' ',' ','#',' ',' ',' ',' ',' ',' ',' ',' ',' ',' ',' ',' ',' ',' ',' ',' ',' ',' ',' ',' ','#',' ',' ',' ',' ',' ',' ',' ',' ',' ',' ',' ',' ',' ',' ','#'},
{'#','#','#','#',' ',' ','#',' ',' ','#','#','#','#','#','#','#','#','#','#','#','#','#','#','#','#','#','#','#','#','#','#',' ',' ','#','#','#','#','#','#','#','#','#','#',' ',' ','#'},
{'#',' ',' ','#',' ',' ','#',' ',' ',' ',' ',' ',' ',' ',' ',' ',' ',' ',' ',' ',' ',' ',' ',' ',' ',' ',' ','#',' ',' ',' ',' ',' ','#',' ',' ',' ',' ',' ','#',' ',' ','#',' ',' ','#'},
{'#',' ',' ','#',' ',' ','#','#','#','#',' ',' ','#','#','#','#','#','#','#','#','#','#','#','#','#',' ',' ','#',' ',' ','#','#','#','#',' ',' ','#',' ',' ','#',' ',' ','#',' ',' ','#'},
{'#',' ',' ','#',' ',' ','#',' ',' ',' ',' ',' ','#',' ',' ',' ',' ',' ','#',' ',' ',' ',' ',' ','#',' ',' ','#',' ',' ','#',' ',' ',' ',' ',' ','#',' ',' ',' ',' ',' ','#',' ',' ','#'},
{'#',' ',' ','#',' ',' ','#',' ',' ','#','#','#','#','#','#','#',' ',' ','#','#','#','#',' ',' ','#',' ',' ','#',' ',' ','#',' ',' ','#','#','#','#','#','#','#','#','#','#',' ',' ','#'},
{'#',' ',' ',' ',' ',' ','#',' ',' ','#',' ',' ',' ',' ',' ',' ',' ',' ',' ',' ',' ',' ',' ',' ','#',' ',' ','#',' ',' ','#',' ',' ',' ',' ',' ',' ',' ',' ',' ',' ',' ',' ',' ',' ','#'},
{'#','#','#','#',' ',' ','#',' ',' ','#',' ',' ','#','#','#','#','#','#','#','#','#','#',' ',' ','#',' ',' ','#',' ',' ','#',' ',' ','#','#','#','#','#','#','#','#','#','#','#','#','#'},
{'#',' ',' ','#',' ',' ','#',' ',' ','#',' ',' ','#',' ',' ','#',' ',' ',' ',' ',' ',' ',' ',' ','#',' ',' ','#',' ',' ','#',' ',' ','#',' ',' ',' ',' ',' ',' ',' ',' ',' ',' ',' ','#'},
{'#',' ',' ','#',' ',' ','#',' ',' ','#',' ',' ','#',' ',' ','#','#','#','#','#','#','#',' ',' ','#',' ',' ','#',' ',' ','#',' ',' ','#',' ',' ','#','#','#','#','#','#','#',' ',' ','#'},
{'#',' ',' ','#',' ',' ','#',' ',' ','#',' ',' ','#',' ',' ','#',' ',' ',' ',' ',' ','#',' ',' ','#',' ',' ','#',' ',' ','#',' ',' ','#',' ',' ','#',' ',' ',' ',' ',' ','#',' ',' ','#'},
{'#',' ',' ','#',' ',' ','#',' ',' ','#',' ',' ','#',' ',' ','#','#','#','#','#','#','#',' ',' ','#',' ',' ','#',' ',' ','#',' ',' ','#',' ',' ','#',' ',' ','#',' ',' ','#',' ',' ','#'},
{'#',' ',' ','#',' ',' ','#',' ',' ','#',' ',' ','#',' ',' ',' ',' ',' ',' ',' ',' ','#',' ',' ','#',' ',' ','#',' ',' ','#',' ',' ','#',' ',' ','#',' ',' ','#',' ',' ','#',' ',' ','#'},
{'#',' ',' ','#',' ',' ','#',' ',' ','#',' ',' ','#','#','#','#','#','#','#','#','#','#','#','#','#',' ',' ','#',' ',' ','#',' ',' ','#',' ',' ','#','#','#','#',' ',' ','#',' ',' ','#'},
{'#',' ',' ',' ',' ',' ','#',' ',' ','#',' ',' ',' ',' ',' ',' ',' ',' ',' ',' ',' ',' ',' ',' ',' ',' ',' ','#',' ',' ','#',' ',' ','#',' ',' ',' ',' ',' ',' ',' ',' ','#',' ',' ','#'},
{'#',' ',' ','#','#','#','#',' ',' ','#',' ',' ','#','#','#','#','#','#','#','#','#','#','#','#','#','#','#','#',' ',' ','#',' ',' ','#','#','#','#','#','#','#',' ',' ','#',' ',' ','#'},
{'#',' ',' ','#',' ',' ',' ',' ',' ','#',' ',' ','#',' ',' ',' ',' ',' ',' ',' ',' ','#',' ',' ',' ',' ',' ',' ',' ',' ','#',' ',' ',' ',' ',' ','#',' ',' ',' ',' ',' ','#',' ',' ','#'},
{'#',' ',' ','#','#','#','#',' ',' ','#',' ',' ','#','#','#','#','#','#','#',' ',' ','#',' ',' ','#','#','#','#','#','#','#','#','#','#',' ',' ','#','#','#','#','#','#','#',' ',' ','#'},
{'#',' ',' ',' ',' ',' ',' ',' ',' ','#',' ',' ',' ',' ',' ',' ',' ',' ',' ',' ',' ','#',' ',' ','#',' ',' ',' ',' ',' ',' ',' ',' ',' ',' ',' ',' ',' ',' ',' ',' ',' ',' ',' ',' ','#'},
{'#','#','#','#','#','#','#','#','#','#','#','#','#','#','#','#','#','#','#','#','#','#','#','#','#',' ',' ','#','#','#','#','#','#','#','#','#','#','#','#','#','#','#','#','#','#','#'},
